13WB_13WB_13WB_13WB_13WB_13WB_13WB_13WB_13WB_13WB_13WB_13WB_13WB_13WB_13WB_13WB_13WB_13WB_13WB_13WB_13WB_13WB_13WB_13WB_13WB_13WB_13WB
13WB_00TF_00TF_00TF_00TF_00TF_00TF_00TF_00TF_00TF_00TF_00TF_00TF_00TF_00TF_00TF_00TF_00TF_00TF_00TF_00TF_00TF_00TF_00TF_00TF_00TF_13BW
13WB_00TF_3130_3130_3130_3350_00TF_00TF_00TF_00TF_00TF_00TF_00TF_00TF_00TF_00TF_00TF_00TF_00TF_3350_00TF_00TF_3130_3130_3130_00TF_13BW
13WB_00TF_3130_3130_3130_00TF_00TF_00TF_00TF_00TF_00TF_00TF_00TF_00TF_00TF_00TF_00TF_00TF_00TF_00TF_00TF_00TF_3130_3130_3130_00TF_13BW
13WB_00TF_3130_3130_3130_00TF_00TF_00TF_00TF_00TF_00TF_00TF_00TF_00TF_00TF_00TF_00TF_00TF_00TF_00TF_00TF_00TF_3130_3130_3130_00TF_13BW
23WD_00CA_00CA_00CA_00CA_00CA_00CA_00CA_00CA_00CA_00CA_00CA_00CA_00CA_00CA_00CA_00CA_00CA_00CA_00CA_00CA_00CA_00CA_00CA_00CA_00CA_23WD
13WB_00TF_3130_3130_3130_00TF_00TF_00TF_00TF_00TF_00TF_00TF_3220_00TF_00TF_00TF_00TF_00TF_00TF_00TF_00TF_00TF_3130_3130_3130_00TF_13BW
13WB_00TF_3130_3130_3130_00TF_00TF_00TF_00TF_00TF_00TF_00TF_00TF_00TF_00TF_00TF_00TF_3350_00TF_00TF_00TF_00TF_3130_3130_3130_00TF_13BW
13WB_00TF_3130_3130_3130_3350_00TF_00TF_00TF_00TF_00TF_00TF_00TF_00TF_00TF_00TF_00TF_00TF_00TF_00TF_00TF_00TF_3130_3130_3130_00TF_13BW
13WB_00TF_00TF_00TF_00TF_00TF_00TF_00TF_00TF_00TF_00TF_00TF_00TF_00TF_00TF_00TF_00TF_00TF_00TF_00TF_00TF_00TF_00TF_00TF_00TF_00TF_13BW
13WB_13BW_13BW_13BW_13BW_13BW_13BW_13BW_13BW_13BW_13BW_13BW_13BW_13BW_13BW_13BW_13BW_13BW_13BW_13BW_13BW_13BW_13BW_13BW_13BW_13BW_13BW