11SW_11SW_11SW_11SW_11SW_11SW_11SW_11SW_11SW_11SW_11SW_11SW_11SW_11SW_11SW_11SW_11SW_11SW_11SW_11SW_11SW_11SW_11SW_11SW_11SW_11SW_11SW
11SW_00TF_00TF_00TF_00TF_00TF_00TF_00TF_00TF_00TF_00TF_00TF_00TF_00TF_00TF_00TF_00TF_00TF_00TF_00TF_00TF_00TF_00TF_00TF_00TF_00TF_11SW
11SW_00TF_00TF_00TF_00TF_00TF_00TF_00TF_00TF_00TF_00TF_00TF_00TF_00TF_00TF_00TF_00TF_00TF_00TF_00TF_00TF_00TF_00TF_00TF_00TF_00TF_11SW
11SW_00TF_00TF_00TF_00TF_00TF_00TF_00TF_00TF_00TF_00TF_00TF_00TF_00TF_00TF_00TF_00TF_00TF_00TF_00TF_00TF_00TF_00TF_00TF_00TF_00TF_11SW
23WD_00TF_00TF_00TF_00TF_00TF_00TF_00TF_00TF_00TF_00TF_00TF_00TF_00TF_00TF_00TF_00TF_00TF_00TF_00TF_00TF_00TF_00TF_00TF_00TF_00TF_23WD
11SW_00TF_00TF_00TF_00TF_00TF_00TF_00TF_00TF_00TF_00TF_00TF_00TF_00TF_00TF_00TF_00TF_00TF_00TF_00TF_00TF_00TF_00TF_00TF_00TF_00TF_11SW
11SW_00TF_3150_3150_00TF_00TF_00TF_3150_3150_00TF_00TF_00TF_00TF_00TF_00TF_3150_00TF_00TF_00TF_00TF_00TF_00TF_00TF_00TF_00TF_00TF_11SW
11SW_00TF_3150_3150_00TF_00TF_00TF_3150_3150_00TF_00TF_00TF_00TF_00TF_00TF_00TF_00TF_00TF_00TF_00TF_00TF_00TF_00TF_00TF_00TF_00TF_11SW
11SW_13BW_13BW_13BW_13BW_13BW_13BW_13BW_13BW_13BW_13BW_13BW_13BW_13BW_13BW_13BW_13BW_13BW_13BW_13BW_13BW_13BW_13BW_13BW_13BW_13BW_13BW