13WR_13WR_13WR_13WR_13WR_13WR_13WR_13WR_13WR_13WR_13WR_13WR_13WR_13WR_13WR_13WR_13WR_13WR_13WR_13WR_13WR_13WR_13WR_13WR_13WR_13WR_13WR
13WR_00TF_00TF_00TF_00TF_00TF_00TF_00TF_00TF_3130_00TF_00TF_00TF_00TF_00TF_00TF_00TF_00TF_00TF_00TF_00TF_00TF_00TF_00TF_00TF_00TF_13BW
13WR_00TF_3450_00TF_00TF_00TF_00TF_00TF_11TA_3130_3130_00TF_00VE_00TF_00TF_11TA_00TF_00TF_00TF_00TF_00TF_00TF_00TF_00TF_00TF_00TF_13BW
13WR_00TF_00TF_00TF_00TF_00TF_00TF_00TF_11TA_11TA_11TA_11TA_11TA_11TA_11TA_11TA_00TF_00TF_00TF_00TF_00TF_00TF_00TF_00TF_00TF_00TF_13BW
13WR_00TF_00TF_00TF_00TF_00TF_00TF_00TF_00TF_3450_00TF_00TF_00TF_00TF_00TF_00TF_00TF_00TF_00TF_00TF_00TF_00TF_00TF_00TF_00TF_00TF_13WR
23WD_00CA_00CA_00CA_00CA_00CA_00CA_00CA_00CA_00CA_00CA_00CA_00CA_00CA_00CA_00CA_00CA_00CA_00CA_00CA_00CA_00CA_00CA_00CA_00CA_00CA_23WD
13WR_00TF_00TF_00TF_00TF_00TF_00TF_00TF_00TF_00TF_00TF_00TF_00TF_00TF_00TF_00TF_00TF_00TF_3450_00TF_00TF_00TF_00TF_00TF_00TF_00TF_13WR
13WR_00TF_00TF_00TF_00TF_00TF_00TF_00TF_00TF_00TF_00TF_00TF_00TF_00TF_00TF_00TF_00TF_00TF_00TF_00TF_00TF_00TF_00TF_00TF_00TF_00TF_13BW
13WR_00TF_00TF_00TF_3450_00TF_00TF_00TF_00TF_00TF_00TF_00TF_00TF_00TF_00TF_3450_00TF_00TF_00TF_00TF_00TF_00TF_00TF_3450_00TF_00TF_13BW
13WR_00TF_11TA_11TA_11TA_00TF_00TF_00TF_11TA_11TA_11TA_00TF_00TF_00TF_11TA_11TA_11TA_00TF_00TF_00TF_00TF_00TF_00TF_00TF_00TF_00TF_13BW
13WR_13BW_13BW_13BW_13BW_13BW_13BW_13BW_13BW_13BW_13BW_13BW_13BW_13BW_13BW_13BW_13BW_13BW_13BW_13BW_13BW_13BW_13BW_13BW_13BW_13BW_13BW