13WW_13WW_13WW_13WW_13WW_13WW_13WW_13WW_13WW_13WW_00TF_00TF_13WW_13WW_13WW_13WW_13WW_13WW_13WW_13WW_13WW_13WW
13WW_00TF_00TF_00TF_00TF_00TF_00TF_00TF_00TF_00TF_00TF_00TF_00TF_00TF_00TF_00TF_00TF_00TF_00TF_00TF_00TF_11SW
13WW_00TF_00TF_00TF_13WW_00TF_00TF_00TF_00TF_00TF_00TF_00TF_00TF_00TF_00TF_00TF_00TF_00TF_00TF_00TF_00TF_11SW
23SW_00TF_00TF_00TF_00TF_00TF_00TF_00TF_00TF_00TF_00TF_00TF_00TF_00TF_00TF_00TF_00TF_00TF_00TF_00TF_00TF_11SW
13WW_00TF_00TF_00TF_00TF_00TF_00TF_00TF_00TF_00TF_00TF_00TF_00TF_13WW_00TF_00TF_00TF_00TF_00TF_00TF_00TF_11SW
13WW_00TF_00TF_00TF_00TF_00TF_00TF_00TF_00TF_00TF_00TF_00TF_00TF_00TF_00TF_00TF_00TF_00TF_00TF_00TF_00TF_11SW
11SW_11SW_11SW_11SW_11SW_11SW_11SW_11SW_11SW_13WW_12HW_13WW_11SW_11SW_11SW_11SW_11SW_11SW_11SW_11SW_11SW_11SW